###################
#CCCBCCCC#CCCCOCCC#
#C##.###C#C###.##C#
#C##.###C#C###.##C#
#CCC.CCCCCCCCC.CCC#
#C##.#C#####C#.##C#
#CCC.#CCC#CCC#.CCC#
####.###.#.###.####
...#.#...R...#.#...
####.#.#####.#.####
.......#...#.......
####.#.#####.#.####
...#.#.......#.#...
####.#.#####.#.####
#CCC.CCCC#CCCC.CCC#
#C##.###C#C###.##C#
#CC#.CCC.M.CCC.#CC#
##C#.#C#####C#.#C##
#CCC.#CCC#CCC#.CCC#
#C######C#C######C#
#P................#
###################
