###################
#CCCCCCCC#CCCCCCCC#
#C##C###C#C###C##C#
#C##C###C#C###C##C#
#CCCCCCCCCCCCCCCCC#
#C##C#C#####C#C##C#
#CCCC#CCC#CCC#CCCC#
####C###.#.###C####
...#C#...R...#C#...
####C#.#####.#C####
....C..#OPB#..C....
####C#.#####.#C####
...#C#.......#C#...
####C#.#####.#C####
#CCCCCCCC#CCCCCCCC#
#C##C###C#C###C##C#
#CC#CCCC.M.CCCC#CC#
##C#C#C#####C#C#C##
#CCCC#CCC#CCC#CCCC#
#C######C#C######C#
#CCCCCCCCCCCCCCCCC#
###################
